NO ./textures/north.xpm
SO ./textures/south.xpm
WE ./textures/west.xpm
EA ./textures/east.xpm

F 40,40,40
C 80,80,80

        1111111111111111
        1000000001111001
        1011100000000001
        1000100111111111
111111111010100000000001
100000001010101111111111
10E010001010000000000001
100010001011111110011111
111111111111111111111111
