NO ./textures/north.xpm
SO ./textures/south.xpm
WE ./textures/west.xpm
EA ./textures/east.xpm

F 220,100,0
C 0,100,150

11111111
100N0001
10000001
10S00001
11111111
