NO ./textures/north.xpm
SO ./textures/south.xpm
EA ./textures/east.xpm

F 220,100,0
C 0,100,150

11111111
100N0001
11111111
