NO ./textures/north.xpm
SO ./textures/south.xpm
WE ./textures/west.xpm
EA ./textures/east.xpm

F 80,60,40
C 120,180,220

11111111
100W0001
10000001
10000001
11100111
