NO ./textures/north.xpm
SO ./textures/south.xpm
WE ./textures/west.xpm
EA ./textures/east.xpm

F 80,60,40
C 120,180,220

   1
  101
1100011
1N00011
1111111