NO ./textures/north.xpm
SO ./textures/south.xpm
WE ./textures/west.xpm
EA ./textures/east.xpm

F 80,60,40
C 120,180,220

11111111
10000001
10111001      1111
100N0101      1111
11111111      1111
