NO ./textures/north.xpm
SO ./textures/south.xpm
WE ./textures/west.xpm
EA ./textures/east.xpm

F 80,60,40
C 120,180,220

111111111111111111111111
100010000000000001000001
101010101111111111010101
101000100000001000010001
101010101111011111010101
100010001000000001000101
111110111011111111111101
100000001000000000000001
101111101011111111101111
100000001000000010000001
111111101111010010111111
100000000000010N10000001
101111111111111111111101
100000000000000000000001
111111111111111111111111

