NO ./textures/north.xpm
SO ./textures/south.xpm
WE ./textures/west.xpm
EA ./textures/east.xpm

F 80,60,40
C 120,180,220

11111111111111111
10000001
10111001      1111
100N01011     1111
111111111111  111111
