NO ./textures/north.xpm
SO ./textures/south.xpm
EA ./textures/east.xpm

F 80,60,40
C 120,180,220

11111111
100N0001
11111111
