NO ./textures/north.xpm
SO ./textures/south.xpm
WE ./textures/west.xpm
EA ./textures/east.xpm

F 220,180,120
C 135,206,235

11111111
10000001
10111001
100N0101
11111111
