NO ./textures/north.xpm
SO ./textures/south.xpm
EA ./textures/east.xpm

C 120,180,220
F 80,60,40

11111111
10000001
10111001
100N0101
11111111
